###############################
# ............                #
# ############ ################
#                             #
#  #### ###########           #
#     # #                     #
#     # ###########           #
#                             #
###############################